1000000000000000
0009990000000000
0009990000060000
0000000000000000
0000000000000000
0000000000000000
0000000000000000
0000000000000002